1 19 24
########################
#p    3ff  fx   s  fff2#
# # # # # # # #f# #f# ##
#      2xfx    b       #
#f# # #s# #f# # #f#s# ##
#fx b  fx    f    x    #
# # # #2# # #s# #x# # ##
#      b1xs 3    f  x f#
# #f#2# # #2# # # # # ##
#* s s                 #
# # # #2# #1# # #x# # ##
# f    ff      *    2  #
# # # #*# # # # # # #x##
#   s  s 3f 1 s  2     #
# # # #s# #f#s# # # # ##
#  xf *s         3*  x #
# # # # #2#3# # #1# # ##
#        f1    2 x    *#
########################

